유가금강정경 석자모품 1권  
개부의동삼사 특진 시홍로경 숙국공 식읍 삼천호 사자 증사공 시대감 정호 대광지 대흥선사 삼장사문 불공 봉조역

아(阿) 상자문: 모든 법의 근본이 나지 않기 때문이다.  
아(阿) 거인자문: 모든 법이 적정하기 때문이다.  
이(伊) 상자문: 모든 법의 뿌리를 얻을 수 없기 때문이다.  
이(伊) 거인자문: 모든 법의 재화(재앙과 화)를 얻을 수 없기 때문이다.  
오(塢) 자문: 모든 법의 비유를 얻을 수 없기 때문이다.  
오(污) 자문: 모든 법의 손실과 감소를 얻을 수 없기 때문이다.  
이(哩) 자문: 모든 법의 신통을 얻을 수 없기 때문이다.  
이(哩) 인자문: 모든 법의 종류와 예를 얻을 수 없기 때문이다.  
언() 자문: 모든 법의 오염을 얻을 수 없기 때문이다.  
암(𡃖) 자문: 모든 법의 침몰을 얻을 수 없기 때문이다.  
의(曀) 자문: 모든 법의 구함을 얻을 수 없기 때문이다.  
애(愛) 자문: 모든 법의 자유로움을 얻을 수 없기 때문이다.  
오(污) 자문: 모든 법의 폭류(급류)를 얻을 수 없기 때문이다.  
오(奧) 인거자문: 모든 법의 화생을 얻을 수 없기 때문이다.  
암(闇) 자문: 모든 법의 경계를 얻을 수 없기 때문이다.  
악(惡) 자문: 모든 법의 멀리 떠남을 얻을 수 없기 때문이다.  
가(迦) 상자문: 모든 법이 업을 떠났기 때문이다.  
거(佉) 상자문: 모든 법이 허공과 같아 얻을 수 없기 때문이다.  
아(誐) 상자문: 모든 법의 행을 얻을 수 없기 때문이다.  
가(伽) 거인자문: 모든 법의 일합(하나로 합함)을 얻을 수 없기 때문이다.  
앙(仰) 비호자문: 모든 법의 지분(가지와 부분)을 얻을 수 없기 때문이다.  
좌(左) 자문: 모든 법이 모든 변화를 떠났기 때문이다.  
차(磋) 상자문: 모든 법의 그림자와 형상을 얻을 수 없기 때문이다.  
야(惹) 자문: 모든 법의 생김을 얻을 수 없기 때문이다.  
찬(酇) 거자문: 모든 법의 전쟁과 적을 얻을 수 없기 때문이다.  
양(穰) 상자문: 모든 법의 지혜를 얻을 수 없기 때문이다.  
타(咤) 상자문: 모든 법의 오만을 얻을 수 없기 때문이다.  
타(咤) 상자문: 모든 법의 장양(기름, 자람)을 얻을 수 없기 때문이다.  
나(拏) 상자문: 모든 법의 원수와 적을 얻을 수 없기 때문이다.  
차(茶) 거자문: 모든 법의 집착을 얻을 수 없기 때문이다.  
낭니상반 비호자문: 모든 법의 다툼을 얻을 수 없기 때문이다.  
다(多) 상자문: 모든 법의 여여(있는 그대로)를 얻을 수 없기 때문이다.  
타(他) 상자문: 모든 법의 머무는 곳을 얻을 수 없기 때문이다.  
나(娜) 자문: 모든 법의 보시를 얻을 수 없기 때문이다.  
타(馱) 거자문: 모든 법의 경계를 얻을 수 없기 때문이다.  
낭(曩) 자문: 모든 법의 이름을 얻을 수 없기 때문이다.  
파(跛) 자문: 모든 법의 제일의 진리를 얻을 수 없기 때문이다.  
파(頗) 자문: 모든 법이 단단하지 않고 거품이 모인 것과 같기 때문이다.  
마(麽) 자문: 모든 법의 속박을 얻을 수 없기 때문이다.  
파(婆) 거중자문: 모든 법의 유(존재)를 얻을 수 없기 때문이다.  
망(莽) 자문: 모든 법의 나와 나의 것을 얻을 수 없기 때문이다.  
야(野) 자문: 모든 법의 승(탈 것, 대승 등)을 얻을 수 없기 때문이다.  
라(囉) 자문: 모든 법이 모든 번뇌의 오염을 떠났기 때문이다.  
라(攞) 자문: 모든 법의 상(모양, 모습)을 얻을 수 없기 때문이다.  
벌(嚩) 자문: 모든 법의 언어와 길이 끊어졌기 때문이다.  
사(捨) 자문: 모든 법의 본성이 적정하기 때문이다.  
쇄(灑) 자문: 모든 법의 성품이 둔하기 때문이다.  
사(娑) 상자문: 모든 법의 모든 진리를 얻을 수 없기 때문이다.  
하(賀) 자문: 모든 법의 인(원인)을 얻을 수 없기 때문이다.  
걸쇄이합자문: 모든 법의 다함을 얻을 수 없기 때문이다.

유가금강정경 석자모품 1권  
병오년 고려국 대장도감 봉칙 조조